..#########..
.###########.
#############
#############
###=#####=###
###=#####=###
###=#####=###
#############
#############
#############
.###########.
..#########..
..#########..