..#########..
.###########.
#############
#############
###.#####.###
###.#####.###
###.#####.###
#############
#############
#############
.###########.
..#########..
..#########..